6 6
######
#....#
#.o..#
#..x.#
#&...#
######