9 8
???#####
####...#
#..#.o.#
#..o...#
#x..####
#x#.o.#?
#x#.#.#?
###&..#?
??#####?