6 8
?#######
##&##xx#
#.oo.ox#
#...o.x#
####...#
???#####